Dance
Alt+` 	 Swap case 	 editorTextFocus && dance.mode == 'normal'
` 	 Transform to lower case 	 editorTextFocus && dance.mode == 'normal'
Shift+` 	 Transform to upper case 	 editorTextFocus && dance.mode == 'normal'
Shift+7 	 Align selections 	 editorTextFocus && dance.mode == 'normal'
Shift+Alt+7 	 Copy indentation 	 editorTextFocus && dance.mode == 'normal'
Shift+Alt+, 	 Deindent selected lines 	 editorTextFocus && dance.mode == 'normal'
Shift+, 	 Deindent selected lines (including incomplete indent) 	 editorTextFocus && dance.mode == 'normal'
Shift+. 	 Indent selected lines 	 editorTextFocus && dance.mode == 'normal'
Shift+Alt+. 	 Indent selected lines (including empty lines) 	 editorTextFocus && dance.mode == 'normal'
Alt+D 	 Delete 	 editorTextFocus && dance.mode == 'normal'
Alt+C 	 Delete and switch to Insert 	 editorTextFocus && dance.mode == 'normal'
Shift+Alt+R 	 Insert contents of register 	 editorTextFocus && dance.mode == 'normal'
Alt+J 	 Join lines 	 editorTextFocus && dance.mode == 'normal'
Shift+Alt+J 	 Join lines and select inserted separators 	 editorTextFocus && dance.mode == 'normal'
Shift+Alt+O 	 Insert new line above each selection 	 editorTextFocus && dance.mode == 'normal'
Alt+O 	 Insert new line below each selection 	 editorTextFocus && dance.mode == 'normal'
Shift+O 	 Insert new line above and switch to insert 	 editorTextFocus && dance.mode == 'normal'
O 	 Insert new line below and switch to insert 	 editorTextFocus && dance.mode == 'normal'
P 	 Paste after and select 	 editorTextFocus && dance.mode == 'normal'
Alt+P 	 Paste all after and select 	 editorTextFocus && dance.mode == 'normal'
Shift+P 	 Paste before and select 	 editorTextFocus && dance.mode == 'normal'
Shift+Alt+P 	 Paste all before and select 	 editorTextFocus && dance.mode == 'normal'
R 	 Replace characters 	 editorTextFocus && dance.mode == 'normal'
Ctrl+R 	 Pick register and replace 	 editorTextFocus && dance.mode == 'normal'
Ctrl+R 	 Pick register and replace 	 editorTextFocus && dance.mode == 'insert'
D 	 Copy and delete 	 editorTextFocus && dance.mode == 'normal'
D 	 Copy and delete 	 editorTextFocus && dance.mode == 'select'
C 	 Copy, delete and switch to Insert 	 editorTextFocus && dance.mode == 'normal'
C 	 Copy, delete and switch to Insert 	 editorTextFocus && dance.mode == 'select'
Shift+R 	 Copy and replace 	 editorTextFocus && dance.mode == 'normal'
Shift+Q 	 Start recording 	 editorTextFocus && dance.mode == 'normal' && !dance.isRecording
Escape 	 Stop recording 	 editorTextFocus && dance.mode == 'normal' && dance.isRecording
Shift+Q 	 Stop recording 	 editorTextFocus && dance.mode == 'normal' && dance.isRecording
Q 	 Replay recording 	 editorTextFocus && dance.mode == 'normal'
Shift+U 	 Redo 	 editorTextFocus && dance.mode == 'normal'
Shift+U 	 Redo 	 editorTextFocus && dance.mode == 'select'
Shift+Alt+U 	 Redo a change of selections 	 editorTextFocus && dance.mode == 'normal'
. 	 Repeat last edit without a command 	 editorTextFocus && dance.mode == 'normal'
NumPad_Decimal 	 Repeat last edit without a command 	 editorTextFocus && dance.mode == 'normal'
Alt+. 	 Repeat last seek 	 editorTextFocus && dance.mode == 'normal'
U 	 Undo 	 editorTextFocus && dance.mode == 'normal'
U 	 Undo 	 editorTextFocus && dance.mode == 'select'
Alt+U 	 Undo a change of selections 	 editorTextFocus && dance.mode == 'normal'
Escape 	 Cancel Dance operation 	 editorTextFocus && dance.mode == 'normal' && !dance.isRecording && !markersNavigationVisible
Escape 	 Cancel Dance operation 	 editorTextFocus && dance.mode == 'input'
Shift+' 	 Select register for next command 	 editorTextFocus && dance.mode == 'normal'
A 	 Insert after 	 editorTextFocus && dance.mode == 'normal'
I 	 Insert before 	 editorTextFocus && dance.mode == 'normal'
Shift+A 	 Insert at line end 	 editorTextFocus && dance.mode == 'normal'
Shift+I 	 Insert at line start 	 editorTextFocus && dance.mode == 'normal'
Escape 	 Set mode to Normal 	 editorTextFocus && dance.mode == 'insert'
Escape 	 Set mode to Normal 	 editorTextFocus && dance.mode == 'select'
Ctrl+V 	 Temporary Insert mode 	 editorTextFocus && dance.mode == 'normal'
Ctrl+V 	 Temporary Normal mode 	 editorTextFocus && dance.mode == 'insert'
/ 	 Search 	 editorTextFocus && dance.mode == 'normal'
Shift+/ 	 Search (extend) 	 editorTextFocus && dance.mode == 'normal'
Alt+/ 	 Search backward 	 editorTextFocus && dance.mode == 'normal'
Shift+Alt+/ 	 Search backward (extend) 	 editorTextFocus && dance.mode == 'normal'
NumPad_Divide 	 Search 	 editorTextFocus && dance.mode == 'normal'
N 	 Select next match 	 editorTextFocus && dance.mode == 'normal'
Shift+N 	 Add next match 	 editorTextFocus && dance.mode == 'normal'
Alt+N 	 Select previous match 	 editorTextFocus && dance.mode == 'normal'
Shift+Alt+N 	 Add previous match 	 editorTextFocus && dance.mode == 'normal'
Alt+NumPad_Multiply 	 Search current selection 	 editorTextFocus && dance.mode == 'normal'
Shift+8 	 Search current selection (smart) 	 editorTextFocus && dance.mode == 'normal'
Shift+Alt+8 	 Search current selection 	 editorTextFocus && dance.mode == 'normal'
NumPad_Multiply 	 Search current selection (smart) 	 editorTextFocus && dance.mode == 'normal'
Alt+A 	 Select whole object 	 editorTextFocus && dance.mode == 'normal'
Alt+A 	 Select whole object 	 editorTextFocus && dance.mode == 'insert'
] 	 Select to whole object end 	 editorTextFocus && dance.mode == 'normal'
Shift+] 	 Extend to whole object end 	 editorTextFocus && dance.mode == 'normal'
Alt+I 	 Select inner object 	 editorTextFocus && dance.mode == 'normal'
Alt+I 	 Select inner object 	 editorTextFocus && dance.mode == 'insert'
Alt+] 	 Select to inner object end 	 editorTextFocus && dance.mode == 'normal'
Shift+Alt+] 	 Extend to inner object end 	 editorTextFocus && dance.mode == 'normal'
Alt+[ 	 Select to inner object start 	 editorTextFocus && dance.mode == 'normal'
Shift+Alt+[ 	 Extend to inner object start 	 editorTextFocus && dance.mode == 'normal'
[ 	 Select to whole object start 	 editorTextFocus && dance.mode == 'normal'
Shift+[ 	 Extend to whole object start 	 editorTextFocus && dance.mode == 'normal'
M 	 Select to next enclosing character 	 editorTextFocus && dance.mode == 'normal'
Shift+M 	 Extend to next enclosing character 	 editorTextFocus && dance.mode == 'normal'
Alt+M 	 Select to previous enclosing character 	 editorTextFocus && dance.mode == 'normal'
Shift+Alt+M 	 Extend to previous enclosing character 	 editorTextFocus && dance.mode == 'normal'
T 	 Select to character (excluded) 	 editorTextFocus && dance.mode == 'normal'
T 	 Extend to character (excluded) 	 editorTextFocus && dance.mode == 'select'
Shift+T 	 Extend to character (excluded) 	 editorTextFocus && dance.mode == 'normal'
Shift+T 	 Extend to character (excluded, backward) 	 editorTextFocus && dance.mode == 'select'
Alt+T 	 Select to character (excluded, backward) 	 editorTextFocus && dance.mode == 'normal'
Shift+Alt+T 	 Extend to character (excluded, backward) 	 editorTextFocus && dance.mode == 'normal'
F 	 Select to character (included) 	 editorTextFocus && dance.mode == 'normal'
F 	 Extend to character (included) 	 editorTextFocus && dance.mode == 'select'
Alt+F 	 Select to character (included, backward) 	 editorTextFocus && dance.mode == 'normal'
Shift+F 	 Extend to character (included) 	 editorTextFocus && dance.mode == 'normal'
Shift+F 	 Extend to character (included, backward) 	 editorTextFocus && dance.mode == 'select'
Shift+Alt+F 	 Extend to character (included, backward) 	 editorTextFocus && dance.mode == 'normal'
W 	 Select to next word start 	 editorTextFocus && dance.mode == 'normal'
B 	 Select to previous word start 	 editorTextFocus && dance.mode == 'normal'
B 	 Extend to previous word start 	 editorTextFocus && dance.mode == 'select'
Shift+B 	 Extend to previous word start 	 editorTextFocus && dance.mode == 'normal'
Shift+B 	 Extend to previous non-whitespace word start 	 editorTextFocus && dance.mode == 'select'
Alt+B 	 Select to previous non-whitespace word start 	 editorTextFocus && dance.mode == 'normal'
Shift+Alt+B 	 Extend to previous non-whitespace word start 	 editorTextFocus && dance.mode == 'normal'
W 	 Extend to next word start 	 editorTextFocus && dance.mode == 'select'
Shift+W 	 Extend to next word start 	 editorTextFocus && dance.mode == 'normal'
Shift+W 	 Extend to next non-whitespace word start 	 editorTextFocus && dance.mode == 'select'
Alt+W 	 Select to next non-whitespace word start 	 editorTextFocus && dance.mode == 'normal'
Shift+Alt+W 	 Extend to next non-whitespace word start 	 editorTextFocus && dance.mode == 'normal'
E 	 Select to next word end 	 editorTextFocus && dance.mode == 'normal'
E 	 Extend to next word end 	 editorTextFocus && dance.mode == 'select'
Shift+E 	 Extend to next word end 	 editorTextFocus && dance.mode == 'normal'
Shift+E 	 Extend to next non-whitespace word end 	 editorTextFocus && dance.mode == 'select'
Alt+E 	 Select to next non-whitespace word end 	 editorTextFocus && dance.mode == 'normal'
Shift+Alt+E 	 Extend to next non-whitespace word end 	 editorTextFocus && dance.mode == 'normal'
Shift+4 	 Filter selections 	 editorTextFocus && dance.mode == 'normal'
Shift+5 	 Select whole buffer 	 editorTextFocus && dance.mode == 'normal'
J 	 Extend down 	 editorTextFocus && dance.mode == 'select'
J 	 Jump down 	 editorTextFocus && dance.mode == 'normal'
Shift+J 	 Extend down 	 editorTextFocus && dance.mode == 'normal'
Down 	 Extend down 	 editorTextFocus && dance.mode == 'select'
Down 	 Jump down 	 editorTextFocus && dance.mode == 'normal'
Shift+Down 	 Extend down 	 editorTextFocus && dance.mode == 'normal'
H 	 Extend left 	 editorTextFocus && dance.mode == 'select'
H 	 Jump left 	 editorTextFocus && dance.mode == 'normal'
Shift+H 	 Extend left 	 editorTextFocus && dance.mode == 'normal'
Left 	 Extend left 	 editorTextFocus && dance.mode == 'select'
Left 	 Jump left 	 editorTextFocus && dance.mode == 'normal'
Shift+Left 	 Extend left 	 editorTextFocus && dance.mode == 'normal'
Right 	 Extend right 	 editorTextFocus && dance.mode == 'select'
Right 	 Jump right 	 editorTextFocus && dance.mode == 'normal'
L 	 Extend right 	 editorTextFocus && dance.mode == 'select'
L 	 Jump right 	 editorTextFocus && dance.mode == 'normal'
Shift+L 	 Extend right 	 editorTextFocus && dance.mode == 'normal'
Alt+L 	 Select to line end 	 editorTextFocus && dance.mode == 'normal'
Shift+Alt+L 	 Extend to line end 	 editorTextFocus && dance.mode == 'normal'
End 	 Select to line end 	 editorTextFocus && dance.mode == 'normal'
Shift+End 	 Extend to line end 	 editorTextFocus && dance.mode == 'normal'
Alt+H 	 Select to line start 	 editorTextFocus && dance.mode == 'normal'
Shift+Alt+H 	 Extend to line start 	 editorTextFocus && dance.mode == 'normal'
Enter 	 Toggle selection indices 	 editorTextFocus && dance.mode == 'normal'
Home 	 Select to line start 	 editorTextFocus && dance.mode == 'normal'
Shift+Home 	 Extend to line start 	 editorTextFocus && dance.mode == 'normal'
Shift+Right 	 Extend right 	 editorTextFocus && dance.mode == 'normal'
G 	 Extend to 	 editorTextFocus && dance.mode == 'select'
G 	 Go to 	 editorTextFocus && dance.mode == 'normal'
Shift+G 	 Extend to 	 editorTextFocus && dance.mode == 'normal'
K 	 Extend up 	 editorTextFocus && dance.mode == 'select'
K 	 Jump up 	 editorTextFocus && dance.mode == 'normal'
Shift+K 	 Extend up 	 editorTextFocus && dance.mode == 'normal'
Up 	 Extend up 	 editorTextFocus && dance.mode == 'select'
Up 	 Jump up 	 editorTextFocus && dance.mode == 'normal'
Shift+Up 	 Extend up 	 editorTextFocus && dance.mode == 'normal'
; 	 Reduce selections to their cursor 	 editorTextFocus && dance.mode == 'normal'
Alt+; 	 Change direction of selections 	 editorTextFocus && dance.mode == 'normal'
Shift+Alt+; 	 Forward selections 	 editorTextFocus && dance.mode == 'normal'
, 	 Clear secondary selections 	 editorTextFocus && dance.mode == 'normal'
Alt+, 	 Clear main selections 	 editorTextFocus && dance.mode == 'normal'
Shift+C 	 Copy selections below 	 editorTextFocus && dance.mode == 'normal'
Shift+Alt+C 	 Copy selections above 	 editorTextFocus && dance.mode == 'normal'
Shift+1 	 Pipe and append 	 editorTextFocus && dance.mode == 'normal'
Shift+Alt+1 	 Pipe and prepend 	 editorTextFocus && dance.mode == 'normal'
Alt+K 	 Keep matching selections 	 editorTextFocus && dance.mode == 'normal'
Shift+Alt+K 	 Clear matching selections 	 editorTextFocus && dance.mode == 'normal'
Shift+- 	 Trim whitespace 	 editorTextFocus && dance.mode == 'normal'
Shift+Alt+- 	 Merge contiguous selections 	 editorTextFocus && dance.mode == 'normal'
Shift+\ 	 Pipe and replace 	 editorTextFocus && dance.mode == 'normal'
Shift+Alt+\ 	 Pipe selections 	 editorTextFocus && dance.mode == 'normal'
Z 	 Restore selections 	 editorTextFocus && dance.mode == 'normal'
Alt+Z 	 Combine register selections with current ones 	 editorTextFocus && dance.mode == 'normal'
Shift+Z 	 Save selections 	 editorTextFocus && dance.mode == 'normal'
Y 	 Copy selections text 	 editorTextFocus && dance.mode == 'normal'
S 	 Leap or select 	 editorTextFocus && dance.mode == 'normal'
Shift+S 	 Split selections 	 editorTextFocus && dance.mode == 'normal'
Alt+S 	 Leap or select backward 	 editorTextFocus && dance.mode == 'normal'
Shift+Alt+S 	 Reduce selections to their ends 	 editorTextFocus && dance.mode == 'normal'
X 	 Expand to lines 	 editorTextFocus && dance.mode == 'normal'
Alt+X 	 Trim lines 	 editorTextFocus && dance.mode == 'normal'
Shift+0 	 Rotate selections clockwise (selections only) 	 editorTextFocus && dance.mode == 'normal'
Shift+Alt+0 	 Rotate selections clockwise 	 editorTextFocus && dance.mode == 'normal'
Shift+9 	 Rotate selections counter-clockwise (selections only) 	 editorTextFocus && dance.mode == 'normal'
Shift+Alt+9 	 Rotate selections counter-clockwise 	 editorTextFocus && dance.mode == 'normal'
V 	 Show view menu 	 editorTextFocus && dance.mode == 'normal'
Shift+V 	 Show view menu (locked) 	 editorTextFocus && dance.mode == 'normal'
